NO ./path_to_the_north_texture.xpm
SO ./path_to_the_south_texture.xpm
WE ./path_to_the_west_texture.xpm
EA ./path_to_the_east_texture.xpm

F 220,      100,15
C 225,30,0

        1111111111111111111111111
        1                  101  1
        1111111111111111111111111
        1000000000110000000000001
        111111111111111111111111111111
        10000000011111     100000000001111
        10110000011111  1  110000000001111
        10110000011111     110000000001111
        100100000011101111100000111111
1111111110110N0001110000000000001
100000000011000001110111111111111
11110111111111011100000010001
11110111111111011101010010001
11000000110101011100000010001
10000000000000001100000010001
10000000000000001101010010001
1100000111010101111101111000111111
11110111 1110101 101111010001
11111111 1111111 111111111111
  1111     1111      111
