NO images/north.xpm
SO images/south.xpm
WE images/west.xpm
EA images/east.xpm

F 43,29,114
C 106,79,240






        1111111111111111111111111
        1                  101  1
        1111111111111111111111111
        1000000000110000000000001
        111111111111111111111111111111
        10000000011111     100000000001111
        10110000011111  1  110000000001111
        10110000011111     110000000001111
        100100000011101111100000111111
11111111101100001110000000000001
100000000011000000010111111111111
11110111111111011100000010001
1111N1111111110D0001010010001
11010100110101011100000010001
10000000000000001100000100111
10000000000000001101010010001
1100000111010101111101111000111111
11110111 1110101 101111010001
11111111 1111111 11111110111
  1111     1111      1111
